9
9
711111777
710001111
710001001
711000051
111011151
100017111
104417111
130017777
111117777