8
8
77111117
11100017
10401011
10100501
10500101
11415401
71300111
71111177
