5
5
11111
13451
10401
15001
11111