7
8
77711117
11110017
10455511
13045501
11144401
77100001
77111111