8
8
77111777
77151777
77101111
11140451
15043111
11114177
77715177
77711177