7
6
111111
101051
104051
130451
104451
100111
111177