8
8
11111111
15000401
15400101
15101001
11101011
71040017
71301117
71111177