10
8
77711117
11110017
10040011
10141001
10040001
15111001
15111101
15030001
11111111