8
9
111117777
100011111
100010001
100014101
111000001
710001111
710300517
711111117
